11101
100P1
100C1
11E00
11111