11101
1000P
100C1
11E01
11111