111111111
1001P1001
100C11111
1E0001111
111111111