11111111
10000CP1
10000E01
11111111